111111111111111111111111111111111
1000100000101000000010100000001G1
101110101010001011100010111110101
100000101000101010001000001010001
101011101111101011101011101010101
101000101000001000101010001000001
101011101011111110101010111011101
1010100*1010001000100010100010001
101010111010111011101110101010101
1000101000100010*0000000001010101
101110101111101101111011101010101
100010001000001000100010001010101
111011111011101010101110111010001
100000100000100010100000100010101
101110111010111010001111101110111
100010001010100000100010001010001
101111101110001110101110111011101
100000100000100000100000000000101
101110111111101111101111101111101
101010000000100010101000101*00101
101000101111101010101010111010101
100010101000001010001010100010101
111010111010111011111010101110101
1S0010000010000000000010001000001
111111111111111111111111111111111
