11111111111111111
101000000010001G1
10101110101011101
101010101010001*1
10101010101110101
10100010100000101
10110010111110101
101*0010001000101
10101111101111101
1*101000100000001
10101110111111111
10100000100010001
10111110101011101
1S000000001000001
11111111111111111