111111111111111111111111111
1000000000100000000000100G1      
101111111010111111111010111
100000100*10100000101000101
101110101110111010101111101
100010100010000010001000001
111110111011111111101011111
100010001010000000101000001
101011101110111110101111101
101000100*00100010100010001
101110111111101010111010101
100010000000001000001010101
101011111111111110111010111
101*00100010000000100010001
101110101011111111101110101
101010001000001000001000101
101011111111101011111111101
100000000010101010000010001
111111111010101011101010101
1S0000000000100000001000101
111111111111111111111111111