11111111111111111111111111111111111111111
1000001000*0000010000000001000000000000G1
10111010101111101011111110101110101111101
10001000101010000010000010000010101000001
11101111101010111011101111111110101110101
10100000101010001000100000001000100010101
10111011101011101110111110111010111011101
10000010001000000010000010001010001000101
10111110111011111111111011100011011110101
10100000100000100000001000001000000010101
10101111101111101111101110111101101110101
10001000101000001000100000100000001000101
11101010101011111010111101101011111011101
10001010101000000010000000101010000010001
10111010101111111111101111101010111110111
100010101000001000100*1000001010001000001
11101010111111101010111011111011101011101
10001010100000001000101010000010001000101
10101010101111111101100011111110111011101
10101010101000000000001000100000100010001
10111010101111111111001110101111111110111
10100010101000001000000010001000000010001
10101110101011101000111111111011111011101
10100010001000101010100000001010001000001
10111011111110100011101011101010101111101
10001000000010101010001000100010101000001
10101111111010001010111110111110101011111
10101000001000101000100010001000101000001
10111010111101101111101011101010111111101
1S000010000000000000001000000010*00000001
11111111111111111111111111111111111111111
