111111111111111111111111111111111
1000100000101000000010100000001G1
101110101010101011101010111110101
101000101000101010001010001010001
101011101111101011101011101011111
101000101000001000101*10001000001
101011101011111110101010111011101
101010001010001000100010100010001
101010111010111011111110111010101
1000101000100010000000100010101*1
101110101111101111111011101010101
100010001000001000100010001010101
111011111011101110101110111010101
101000100000100010100000100010101
101110111010111010111111101110111
1*0010001010101000100010001010001
101111101110101110101110111011101
100000100000100000100000000000101
101110111111101111101111101111101
101010000000100010101000101000101
101010101111111010101010111010101
100010101000001010001010100010101
111010111010111011111010101110101
1S0010000010000000000010001000001
111111111111111111111111111111111