111111111111111111111
1000000000100000001G1     
101110111011101011101
10001000100*101010001
111011101110111010111
100010001000000010101
111110111111111110101
100000100000000010101
101011101111111010101
10101000100000101*001
101110111110101011101
1010001*0000101000001
101011101111101111111
101000101000101000001
101110101010101111101
1S0000001010000000001
111111111111111111111