111111111111111111111
10000000001   
10111011101
10001000100
11101110111
1100100010
1011101111
1100001000
1010111011
1010100010
1011101111
1010001*00
1010111011
1010001010
1011101010
1S00000010
111111111111111111111