11111111111111111111111111111111111111111
100000100000000010000000001000001000000G1
10111010101111101011111110101110101111111
10001000101010001010000010000010101000001
11101111101010111011101111111110101110101
1010000010101000100010000000100010001*101
10111011101011101110111110111010111011101
10000010001000000010000010001010001000101
10111110111011111111111011101011111110101
10100000100000100000001000001000000010101
10101111101111101111101110111111101110101
1010100010100000100010000010000*001000101
11101010101011111010111111101011111011101
10001010101000000010000000101010000010001
10111010101111111111101111101010111110111
10001010100000100010001000001010001000001
11101010111111101010111011111011101011101
10001010100000001000101010000010001000101
10101010101111111111101011111110111011101
10101010101000000000001000100000100010001
10111010101111111111101110101111111110111
10100010101000001000000010001000000010001
10101110101011101010111111111011111011101
10100010001000101010100000001010001000001
10111011111110101011101011101010101111101
10001000000010101010001000100010101000001
10101111111010101010111110111110101011111
10101*00001000101000100010001000101000001
10111010111111101111101011101010111111101
1S000010000000000000001000001010000000001
11111111111111111111111111111111111111111