11111111111111111111111
100000000000001000000G1
10101110111110101011101
101*0010100010001000001
10111010101011101110101
10001010101000001000001
11111010101111111011011
10000010101010000010001
10101111101010101110101
10101000101*00100000101
10111010101110111110101
10000010001000000010101
10111111111011111010101
10100000001000100010101
10111011101010101111101
1000100010001010100*101
11101101111110101010101
1S000000000000100010001
11111111111111111111111
