11111111111111111111111111111
100000000000000000000000000G1
10111110101111111110111010111
101000001010000*0000001010101
10101110111011111111111000101
10101000100000001000001010001
11101011101111111011101011101
10001010001000000010100010001
10111010111010111110111010101
10001010001010100010000010101
101011101010111*1010111110101
1010000010100010000000001*101
11111011101110101111111010101
10001010001000100010100010101
10101010111011101010101110101
10101010001000001010100000101
10101011101110101010101111101
10100010001000101010000000101
10101110111010101010111110101
10101000100010101010100000101
10111011111010111010101111101
1S000000000010000000100000001
11111111111111111111111111111
