11111111111111111111111
100000000000001000001G1  
10101110111110101011101
10100010100010101000101
10111010101011101110101
10001010101000001010001
11111010101111111011111
1000001*101010000010001
10101111101010101110101
10101000101000100000101
10111010101111111110101
100000100*1000000*10101
10111111111011111010101
10100000001000100010101
10111011101010101111101
10001000100010101000101
11101111111110101010101
1S000000000000100010001
11111111111111111111111