11111111111111111111111111111111111
100010000000000000001000000010100G1
10111011101111111110111011101010111
10100010100010001000100010100010101
10101110111011101011101110111010101
10101000101000100010001000100010101
10101010101110101111101110101110101
10101010001010100000001000100010101
10101011101010111111111011111010101
1000101010101000000*001010000010001
10111010101011111111101010111111101
10000010101000001000001000100000101
11111110101111101011111011101010101
1000100010000000100000101*001010101
10101010111111101111101110111011101
10101010100000101000001000101000101
10101011101011101011101011101110101
10100010001000001*00101010000010001
10111110111111101110111010111011111
10001000100000100010100010100010001
10101011101110111110101110101111101
10101010001000000000100000101000001
11101010111111111011111111101011101
10001010100000100010000000100010101
10111010101110111110111110111110101
1S000010000010000000000010000000001
11111111111111111111111111111111111
