11111111111111111111111111111111111111111111111
1000100000100010000*1000000010000000100000000G1
10101110101011101110101110101011111010111110101
10101000100010001010001000100010001000100010001
10101011111000111011111010101111101110101110101
10100010100010000010001010101000001000000000101
10111110101111111010101011101010111011110111101
10000010101000101000101010001010000000100000101
10111010101010101111101010111111101111101110101
10001110000010001000001000100000001000001010101
11101011111111111011101111101110111011111010101
10101000000000000010000000100010100010000010001
10101111111111111110111010111011110110111011101
10000010001000000000100010001000000000101000001
10111010101011111111101111101110101111101111101
100010001010001000001010*0100000100000000000101
10111111101110101110101011111101111111111110101
10001000001010101000001000000000100000000010001
11101011111010101111111011110111101111101111101
10001010000010101000101000100000001000001000001
10111010111010101010101110111011101111111010111
10100010101000100010100000000010101000000010001
10101110101111111110111101111010111011111110111
10001000100000100010000000100010000010001000001
10111011111010111011110110111011111110101111101
1010001000001000000010001000100000000010*000101
10101111101011111110001011101111111111111110101
10100000101010001000101000100010000000000010001
10111110101110101101101110101010111110111011101
10001000100000100000101000101000100010100010001
11001011101011111110101011101111101011101110111
10001000001000101000100000100000101010000000101
10111111111110001011101110111111101010111011101
1S000000000000100000001000000000001000100000001
11111111111111111111111111111111111111111111111
