111111111111111111111111111111111111111111111
1000000000100000000000001000001000000000000G1
111011111010111011111110101010101100101110101
100010001010101010000010001010000100100010001
101111101000101010111010111011110111111011101
10000*000010001000100010100010000000001000001
111110110111101111101110101111111011101010111
100000100000000000101000001000000000100010001
101101101101111111101111111011100110111011101
101000001000001000101000000010100110000000101
101011111111101010101011101010111110101111101
101000100010001010001010001000100000100010001
101110101010101010111010101110101111101110111
100010001010101010100010100010000110001000101
101111111010111011101110111110110110111011101
10100000001000100010001*100000100110001000001
101011111110101110111010101111100111111111101
101010000010100010001010100010000000000010001
101010111110111010101010111011101111111010111
100010000000001010101010000000100000001000001
101110111111111010101011101110101111111111101
101000100010000010101010000000100000000010001
101011111010111110111000111111101111101011101
101000000010000010100010000000000000001010001
101111111011111010101111111011110111111010101
101000001010000010001000001010000000100000101
101010111010111111011011101011101110111101111
10101000001000000000001010100000*110000000001
101110111111101101101110101111110111111111101
100010000000101000100000101000000000000010001
101010111110111010101010101111111111111110101
1S0000100000000010001010000000000000000000101
111111111111111111111111111111111111111111111
