111111111111111111111111111111111
10001000                       G
10111010
10100010
10101110
10100010
10101110
10101000
10101011
10001010
10111010
10001000
11101111
10100010
10111011
1*001000
10111110
10000010
10111011
10101000
10101010
10001010
11101011
1S001000
111111111111111111111111111111111